#########
#E#S    #
# ##### #
# # ### #
#       #
#########