###########
#E#S  # # #
# ### # # #
#  #  #   #
# ### ### #
# #     # #
# # ##### #
# #       #
# ####### #
#         #
###########

